000111111111111111111111111111
000001111100001100001111100111
000001111100001100001111100111
100000000000001100000000000001
100000000000001100000000000001
100000000000001100000000000001
111001111100000000001111100111
111001111100000000001111100111
111001100000000000000001100111
111001100000000000000001100111
111001100000111111000001100111
100000000000111111000000000001
100000000000000000000000000001
100000000000000000000000000001
100111111000000000000111111001
100111111000000000000111111001
100000000000000000000000000001
100000000000111111000000000001
100000000000111111000000000001
111001100000000000000001100111
111001100000000000000001100111
111001100000000000000001100111
111001111100000000001111100111
111001111100000000001111100111
100000000000001100000000000001
100000000000001100000000000001
100000000000001100000000000001
111001111100001100001111100111
111001111100001100001111100111
111111111111111111111111111111
