000000000000000000001100110011111111111111110011111111111111100
000000000000000000000000110011111111111111110011111001000000000
110011111111111111000000110000000001111111110000001001000000000
110011111111111111001100110000000001110011110000001001001111100
110011000000000000000000110010011111000001110011001001000001100
110011000000000000000000110010011100000000010011001001000001100
110000000000000011000000110000000000000000010011001001111111100
110000000000000011001100110011111100000000010011111000000000000
110011111111110011000000110011111100000000010011111000000000000
110011111111110011000000110011111111000001110000001100000111100
000000000000110011001100110011000000000011110000001100000111100
000000000000110011000000110011000000000011110011111100000110000
110011001100110011000000110011001111110011110011111100111110001
110011001100110011001100000000000001110011110000000000111110001
110011001100110011001100000000000001110011110000000000110010001
110011001100110011001111111110011111110011110011111100110010001
110011000000000011000000000110000000000000000010000000110000001
110011000000000011000000000110000000000000000010000000110000001
111111001100110011111111100000011111111111110011111100110010001
100000001100110000000001100000011000000011110011111100110010011
100000001100110000000001100110011000000011110011111100000010011
111111001100110010011111100110000001110000000011111100000011111
000000000000111110011111100110000001110000000000111100110011100
000000000000111110011111100111111111111110010000111100110011000
001111001100000000000000000000010000000010010000111111111110000
001000001100000000000000000000010000000010011100000000000000000
001000001100111111111001111100111110011111111100000000000000000
001111001100000000001000001100100110000000001100111111111111111
001001001100000000001000001100000110000000001100111000000000000
111001001100111111111111100000000110011001111100111000000000000
111001001100100100000000100000100000011001111100111000000000000
000000001000100100000000000100100000011000000000111001000000010
000000001000100100111100000100100110011000000000111000100000100
100111111001100000000000111111100110011001100111111000010001000
100111111001100000000000111111100111111001100000000000001010000
100111111001100111111111111111100111111111100000000000000100000
000000000000000000000000000001100000000011100110011000000000000
000000000000000000000000000001100000000011100110011000000000000
111100011100110011001111100111111100111111111110011111100110011
111000111000110011000011100111111100111111111110011111000000001
110000110000110011000011100000110000000000000000000001000000001
100001100001110011110000100000000000000000000000000001100000011
000011000011110011110000111111111111111111111111111111110000111
000110000111110011111100001111111111111111111111111111111001111
001100001000000011111100001111110000111110000111111000000000000
001000011000000011111111000011100000011100000011111000000000000
000000111001110000001111000011100000001000000011111001110000100
000001111001110000001111110000000000000000000001111001001000100
100111111001110011001110010000000000000000000001111001000100100
000000000000000011001110011111000000000000000000000001000010100
000000000000000011001110011111000000000000000000000001000001100
111111001111110011000000011111100000000000000011111000000000000
000000000000110011000000011111110000000000000111111000000000000
000000000000110000000000011111111000000000001111111111111110011
111001001100110000000000011111111110000000111111111111111110011
111001001100110011001110011110011111000001111100110010010010010
000001001100110011001110011110000111100011110000110010010010010
000001000000000011001110011110000001110111000000110010010010010
000001000000000011001110011110000000000000000000110010010010010
000001001100110011001111111110000000000000000000110010010010010
111001001100110011001111111111111111100011111111110010010010010
111001111100110011000000000000000000000000000000000000000000000
111001111100110011000000000000000000000000000000000000000000000
