00000000000000000000110011001111111111111111001111110011111111111
00000000000000000000000011001111111111111111001111110011111111111
11001111111111111100000011000000000111111111000000110011000000000
11001111111111111100110011000000000111001111000000110011000000000
11001100000000000000000011001001111100000111001100110011001111100
11001100000000000000000011001001110000000001001100110011001100100
11001111111111001100110011001001110000000001001100110011000000100
11001111111111001100000011000000000000000001001100110011000000100
11000000000000001100000011000000000000000001001100110011111111100
11000000000000001100110011001111110000000001001111110000000000000
11001111111111001100000011001111110000000001001111110000000000000
11001111111111001100000011001111111100000111000000110000011111001
00000000000011001100110011001100000000001111000000110000011111001
00000000000011001100000011001100000000001111001111110000011001001
11001100110011001100000011001100111111001111001111110011111001001
11001100110011001100110000000000000111001111000000000011111000001
11001100110011001100110000000000000111001111000000000011001000001
11001100110011001100111111111001111111001111001111110011001001001
11001100000000001100000000011000000000000000001000000011000001001
11001100000000001100000000011000000000000000001000000011000001001
11111100110011001111111110000001111111111111001111110011001001001
10000000110011000000000110000001100000001111001111110011001001111
10000000110011000000000110011001100000001111001111110000001001111
11111100110011001001111110011000000111000000001111110000001111111
00000000000011111001111110011000000111000000000011110011001111000
00000000000011111001111110011111111111111001000011110011001111000
00111100110000000000000000000001000000001001000011111111111111000
00100000110000000000000000000001000000001001110000000000000000000
00100000110011111111100111110011111001111111110000000000000000000
00111100110000000000100000110010011000000000110011111111111111111
00100100110000000000100000110000011000000000110011100000000000001
11100100110011111111111110000000011001100111110011100000000000001
11100100110010010000000010000010000001100111110011100000000000001
00000000100010010000000000010010000001100000000011100100000001001
00000000100010010011110000010010011001100000000011100010000010001
10011111100110000000000011111110011001100110011111100001000100001
10011111100110000000000011111110011111100110000000000000101000001
10011111100110011111111111111110011111111110000000000000010000001
00000000000000000000000000000110000000001110011001100000000000001
00000000000000000000000000000110000000001110011001100000000000001
11110001110011001100111110011111110011111111111001111110011001111
11100011100011001100001110011111110011111111111001111100000000111
11000011000011001100001110000011000000000000000000000100000000111
10000110000111001111000010000000000000000000000000000110000001111
00001100001111001111000011111111111111111111111111111111000011111
00011000011111001111110000111111111111111111111111111111100111111
00110000100000001111110000111111000011111000011111100000000000001
00100001100000001111111100001110000001110000001111100000000000001
00000011100111000000111100001110000000100000001111100111000001001
00000111100111000000111111000000000000000000000111100100100001001
10011111100111001100111001000000000000000000000111100100010001001
00000000000000001100111001111100000000000000000000000100001001001
00000000000000001100111001111100000000000000000000000100000111001
11111100111111001100000001111110000000000000001111100000000000001
00000000000011001100000001111111000000000000011111100000000000001
00000000000011000000000001111111100000000000111111111111111001111
11100100110011000000000001111111111000000011111111111111111001111
11100100110011001100111001111001111100000111110011001001001001001
00000100110011001100111001111000011110001111000011001001001001001
00000100000000001100111001111000000111011100000011001001001001001
00000100000000001100111001111000000000000000000011001001001001001
00000100110011001100111111111000000000000000000011001001001001001
11100100110011001100111111111111111110001111111111001001001001001
11100111110011001100000000000000000000000000000000000000000000000
11100111110011001100000000000000000000000000000000000000000000000
