000111111111111111111111111111
000000000000001100000000000001
000000000000001100000000000001
100000000000001100000000000001
100000000000001100000000000001
100000000000001100000000000001
100001111100000000001111100001
100001111100000000001111100001
100001100000000000000001100001
100001100000000000000001100001
100001100000111111000001100001
100000000000111111000000000001
100000000000000000000000000001
100000000000000000000000000001
100000000000000000000000000001
100000000000000000000000000001
100000000000000000000000000001
100000000000111111000000000001
100000000000111111000000000001
100001100000000000000001100001
100001100000000000000001100001
100001100000000000000001100001
100001111100000000001111100001
100001111100000000001111100001
100000000000001100000000000001
100000000000001100000000000001
100000000000001100000000000001
100000000000001100000000000001
100000000000001100000000000001
111111111111111111111111111111
