000000000000000000000000000000000000000000000000000000000000000
000000000000000000000000000000000000000000000000000000000000000
001111100111111111110011100000001111100111111111111001111111100
001111100100000000000000100000001111100111111111111001111111100
001000100100000000000000001001001100000000000000001100100000100
001000100100000000000000001001001100000000000000001100100000100
001000100111111111110010001001001100011111111100111100111100100
001000100000000000010010001001001100000010011001000000000100100
001000000000000000010010001001001100000010011001000000000100100
001000000111111100010010001111001111110010011001001110011100100
001000100100010000010000000000000000110000011001001100000000100
001000100100010000010000000000000000110000011001001100000000100
001000111100010000010000000000000000111110011001111100000000100
001000111100010011110011111111111100111110011001111100111100100
001000000000010000000010000001000000000010011000000000100000100
001000000000010000000010000001000000000010011000000000100000100
001111100111110011110011111001000111111110011111111100100100100
000000100100000000010011111001000111111110001111001100000100100
000000100100000000010000000001000100000000000011001100000100100
000000100100000000010000000001000100000000000011001111100100100
000000100100011101111111111001111100111111111111001111100100100
000000100100010010000000011000000100110110000000000000100100100
001000100100010010000000011000000100110110000000000000100100100
001111100100010011111111011111100100110110011001111100100100100
001000000100010011111111001111100100100110011001111100100100100
001000000100010000010000000001100100000110011001001100100100100
001000000100010000010001111001100111111110011111001100100100100
001111100111110010010011111001100111111110011111001111100100100
000000100000000010010010001001100000000000010000000000000100100
000000100000000010010010001001100000000000010000000000000100100
001000111100011110011110001111100111110011110001111111111100100
001000000100010010000000000000000111110010000011111111111100100
001000000100010010000000000000000100110010000001000000100100100
001000000100010001100000000000000100110010001111000000100100100
001111100100010011001111111001111100110010011111111001001100100
001000100100010000000000001001100000110010011000000001001100100
001000100100010000000000001001100000110010011000000011001100100
001000100100010011111111001111100100110010011111001111001100100
001000100100010011111111000000001100110010011111001000001100100
001000100100000011000011000000000000110010011000001000001100100
001000100100000011000011111001111100111110011000111001111100100
001000100100010011110011111001111100111110011001111001111100100
001000100100010000010000000000000100000000000001000001000000100
001000100100010000010000000000000100000000000001000001000000100
001000111100010010011111001111000111111111111111001111001100100
001000000000010011001111001001000000000011111111001000001100100
001000000000010011000110001001000000000010000000001000001100100
001000000000010011110111001001000000000010000000001000001100100
001000111100010011110111111001000111111110011111001111001100100
001000100100010000000000001000000100000000011001000001001100100
001000100100010000000000001000000100000000011001000001001100100
001000100111111100110011111001111100111110011001001111000000100
001000100000000000000011111001111100100000000001001000001100100
001000100000000000000000000001000100100000000001001000001100100
000000100000000000000000000001000100100000000011001100011100100
000000100000000000001111111111000100100010011111001111111100100
001000000000010010000000001000000000100010011000000000000000100
001000000000010010000000001000000000100010011000000000000000100
001111111111110010001111111001111111100010011111001110011100100
001111111111110010001111111001100000000010011111001110011100100
000000000000000010000000000001100000000010000001001000001100100
000000000000000010000000000001100000000110000001111000001111100
001111111111111111111111111111100111111111111111111001111111100
