00000000000000000000000000000000000000000000000000000000110000000
00000000000000000000000000000000000000000000000000000000110000000
00111110011111111111100111110010001111100111111111111001111111100
00111110010000000000000000010010011111100111111111111001111111100
00100010010000000000000000010010011000000000000000011001000000100
00100010010000000000000000010010011000000000000000011001000000100
00100010011111111111100100010010011000111111110011111001111100100
00100010000000000000100100010010011000000100110010000000001100100
00100000000000000000100100010010011000000100110010000000001100100
00100000011111111000100100011110011111100100110010011100111100100
00100010010001000000100000000000000001100000110010011000000000100
00100010010001000000100000000000000001100000110010011000000000100
00100011110001000000100000000000000001111100110011111000000000100
00100011110001001111100111111111111001111100110011111001111100100
00100000000001001000000100000010000000000100110000000001000000100
00100000000001001000000100000010000000000100110000000001000000100
00111110011111001111100111110010001111111100111111111001001100100
00000010010000000000100111110010001111111100011110011000001100100
00000010010000000000100000000010001000000000000110011000001100100
00000010010000000000100000000010001000000000000110011111001100100
00000010010001111101111111110011111001111111111110011111001100100
00000010010001001100000000110000001001101100000000000001001100100
00100010010001001100000000110000001001101100000000000001001100100
00111110010001001111111110111111001001101100110011111001001100100
00100000010001001111111110011111001001001100110011111001001100100
00100000010001000000100000000011001000001100110010011001001100100
00100000010001000000100011110011001111111100111110011001001100100
00111110011111001100100111110011001111111100111110011111001100100
00000010000000001100100100010011000000000000100000000000001100100
00000010000000001100100100010011000000000000100000000000001100100
00100011110001111100111100011111001111100111100011111111111100100
00100000010001001100000000000000001111100100000111111111111100100
00100000010001001100000000000000001001100100000010000001001100100
00100000010001001110000000000000001001100100011110000001001100100
00111110010001001111111111110011111001100100111111111001001100100
00100010010001000000000000010011000001100100110000000001001100100
00100010010001000000000000010011000001100100110000000011001100100
00100010010001001111111110011111001001100100111110011111001100100
00100010010001001111111110000000011001100100111110011000001100100
00100010010000001100000110000000000001100100110000011000001100100
00100010010000001100000111110011111001111100110001111001111100100
00100010010001001111100111110011111001111100110011111001111100100
00100010010001000001100000000000001000000000000010000001000000100
00100010010001000001100000000000001000000000000010000001000000100
00100011110001001001111110011110001111111111111110011111001100100
00100000000001001100111110010010000000000111111110011000001100100
00100000000001001100000110010010000000000100000000011000001100100
00100000000001001111001110010010000000000100000000011000001100100
00100011110001001111001111110010001111111100111110011111001100100
00100010010001000000000000010000001000000000110010000001001100100
00100010010001000000000000010000001000000000110010000001001100100
00100010011111110011100111110011111001111100110010011111000000100
00100010000000000000100111110011111001000000000010011000001100100
00100010000000000000100000000010001001000000000010011000001100100
00000010000000000000100000000010001001000000000110011100011100100
00000010000000000000111111111110001001000100111110011111111100100
00100000000001001000000000010000000001000100110000000000000000100
00100000000001001000000000010000000001000100110000000000000000100
00111111111111001000111111110011111111000100111110011110011100100
00111111111111001000111111110011000000000100111110011110011100100
00000000000000001000000000000011000000000100000010011000001100100
00000000000000001000000000000011000000001100000011111000001111100
00111111111111111111111111111111001111111111111111111001111111100
00000000000000000001100000000000000000000000000000000000000000000
00000000000000000001100000000000000000000000000000000000000000000
